		NO ./images/wall_n.xpm
		SO       ./images/wall_s.xpm
		WE ./images/wall_e.xpm
		EA ./images/wall_w.xpm

F 45,0,0
C 0,0,65

        1111111111111111111111111
        1000000000110000000000001
        1011000001110000000100001
        10010000000000000000S0001
111111111111000001110000000000001
10000000001100000111D111111111111
11110111111111011100000010001
1111D111111111011101010010001
11000000110101011100000010000
10000000000000001100000010001
10000000000000001101010010001
1100000111010101111101101000111
11110111 1110101 101111010001
11111111 1111111 111111111111